10 10 10 10 10 10 10 10 10 10 10 10 10 10 10 10 10 10 10 10 10 10 10 10 0  4  6  5  0  0  0  0  0  0  0  0
0  0  0  0  0  0  0  0  0  0  0  0  0  0  0  0  0  0  0  0  0  0  0  0  0  4  6  5  0  0  0  0  0  0  0  0
0  0  0  0  0  0  0  0  0  0  0  0  0  0  0  0  0  0  0  0  0  0  0  0  0  4  6  5  0  0  0 25  0  0  0  0
0  0  0  0  0  0  0  0  0  0  0  0  0  0  0  2  1  3  0  0  0  0  0  0  0  4  6  5  0  0  0  0  0  0  0  0
0  0  0  0  0  0  0  0  0  0  0  0  0  0  0  4  6  5  0  0  0  0  0  0  0  4  6  5  0  0  0  0  0  0  0  0
0  0  0  0  0  0  0  0  0  0  0  0  0  0  0  4  6  5  0  0  0  12 13 14 0  4  6  5  0  0  0  0  0  0  0  0
0  0 25  0  0  0  0  0  0  0  0  0  0  0  0  4  6  5  0  0  0  0  0  0  0  4  6  5  0  0  0  0  0  0  0  0
0  0  0  0  0  0 12 13 13 14  0  0  0  2  7  6  6  5  0  0  0  0  0  0  0  4  6  5  0  0  0  0  0  0  0  0
0  0  0  0  0  0  0  0  0  0  0  0  0  4  6  6  6  5  0  0  0  0  0  0  0 10 10 10  0  0  0  0  0  0  0  0
0  0  0  0  0  0  0  0  0  0  0  0  0  4  6  6  6  5  0  0  0  0  0  0  0  0  0  0  0  0  0  0  0  0  0  0
0  0  0  0  0  0  0  0  0  0  0  0  0  4  6  6  6  5  0  0  0  0  0  0  0  0  0  0  0  0  0  0  0  0  0  0
0  0  0  0  0  0  0  0  0  0  0  0  0  4  6  6  6  5  0  0  0  0  0  0  0  9  9  9  0  0  0  0  0  0  0  0
0  0  0  0  0  0  0 12 13 13 14  0  0  4  6  6  6  5  0  0  0 12 14  0  0  4  6  6  8  1  1  1  1  1  1  1
0  0  0  0  0  0  0  0  0  0  0  0  0  4  6  6  6  5  0  0  0  0  0  0  0  4  6  6  6  6  6  6  6  6  6  6
0  0  0  0  0  0  0  0  0  0  0 20  0  4  6  6  6  5  0 25 25  0  0 21  0  4  6  6  6  6  6  6  6  6  6  6
0  0  0  0  0  9  9  9  9  9  9  9  9  6  6  6  6  5  9  9  9  9  9  9  9  4  6  6  6  6  6  6  6  6  6  6
1  1  1  1  7  6  6  6  6  6  6  6  6  6  6  6  6  6  6  6  6  6  6  6  6  6  6  6  6  6  6  6  6  6  6  6
6  6  6  6  6  6  6  6  6  6  6  6  6  6  6  6  6  6  6  6  6  6  6  6  6  6  6  6  6  6  6  6  6  6  6  6
6  6  6  6  6  6  6  6  6  6  6  6  6  6  6  6  6  6  6  6  6  6  6  6  6  6  6  6  6  6  6  6  6  6  6  6
6  6  6  6  6  6  6  6  6  6  6  6  6  6  6  6  6  6  6  6  6  6  6  6  6  6  6  6  6  6  6  6  6  6  6  6
