0  0  0  0  0  0  0  0  0  0  0  0  0  0  0  0  0  0   0  0  0  0  0  0  0  0  0  0  0   0  0  0  0  0  0  0
0  0  0  0  0  0  0  0  0  0  0  0  0  0  0  0  0  0   0  0  0  0  0  0  0  0  0  0  0   0  0  0  0  0  0  0
0  0  0  0  0  0  0  0  0  0  0  0  0  0  0  0  0  0   0  0  0  0  0  0  0  0  0  0  0   0  0  0  0  0  0  0
0  0  0  0  0  0  0  0  0  0  0  0  0  0  0  0  0  0   0  0  0  0  0  0  0  0  0  0  0   0  0  0  0  0  0  0
0  0  0  0  0  0  0  0  0  0  0  0  0  0  0  0  52 40 40 40  53  0  0  0  0  0  0  0  0   0  0  0  0  0  0  0
0  0  0  0  0  0  0  0  0  0  0  0  0  0  0  0  0  0   0  0  0  0  0  0  0  0  0  0  0   0  0  0  0  0  0  0
0  0  0  0  0  0  0  0  0  0  0  0  0  0  0  0  0  0   0  0  0  0  0  0  0  0  0  0  0   0  0  0  0  0  0  0
0  0  0  20  0  0  0  0  0  0  40 40 40 40  0  0  0  0   0  0  0  0  52 40 40 53 0 0  0   0  0  0  0  0  0  0
0  0  52 40 53  0  0  0  0  0  43 43 43 43  0  0  0  0   0  0  0  0  0  0  0  0  0  0  0   0  0  0  0  0  0  0
0  0  0  0  0  0  0  0  0  0  43 43 43 43  0  0  0  0   0  0  0  0  0  0  0  0  0  0  0   0  0  0  0  0  0  0
18 18 18 18 18 18 18 18 18 17 43 43 43 43  0  0  0  0   0  0  0  0  0  0  0  0  0  0  0   0  0  0  0  0  0  0
0  0  0  0  0  0  0  0  0  0  43 43 43 43  0  0  0  0   0  0  0  0  0  0  0  0  0  0  0   0  0  0  0  0  0  0
0  0  0  0  0  0  0  0  0  0  43 43 43 43  0  0  0  0   0  0  0  0  0  0  0  0  0  0  0   0  0  0  0  0  0  0
0  0  0  0  0  0  0  0  0  0  43 43 43 43  0  0  0  0   0  0  0  0  0  0  0  0  0  0  0   0  0  0  0  0  0  0
0  0  0  0  0  0  0  0  0  0  43 43 43 43  0  0  0 0   25 25 25  0  0  0  0  0  0  0  0  0  0  0  0  0  0  0
40 40 40 40 40 40 0  0  0  0  43 43 43 43 0  0  0  0  40 40 40 0  0  0  0 0  0  0  0  40 40 40 40 40 40 40
43 43 43 43 43 43 0  0  0  0 43 43 43 43  0  0  0  0  43 43 43 0  0  0  0 0  0  0  0  43 43 43 43 43 43 43
43 43 43 43 43 43 51 51 51 51 43 43 43 43 51 51 51 51 43 43 43 51 51 51 51 51 51 51 51 43 43 43 43 43 43 43
43 43 43 43 43 43 51 51 51 51 43 43 43 43 51 51 51 51 43 43 43 51 51 51 51 51 51 51 51 43 43 43 43 43 43 43
43 43 43 43 43 43 51 51 51 51 43 43 43 43 51 51 51 51 43 43 43 51 51 51 51 51 51 51 51 43 43 43 43 43 43 43
