0  0  0  0  0  0  0  0  0  0  0  0  4  5  0  0  0  0  6  5  0  0  0  0  0  0  0  0  0  0  0  0  0  0  0  0
0  0  0  0  0  0  0  0  0  0  0  0  4  5  0  0 29  0  6  5  0  0  0  0  0  0  0  0  0  0  0  0  0  0  0  0
0  0  0  0  0  0  0  0  0  0  0  0  4  6 17 18 18 18  6  5  0  0  0 20  0  0  0  0  0  0  0  0  0  0  0  0
0  0  0  0  0  0  0  0  0  0  0  0  4  5  0  0  0  0  6  5  0  0  0  0  0  0  0  0  0  0  0  0  0  0  0  0
0  0  0  0  0  0  0  0  0  0  0  0  4  6 17 18 18 18  6  5  0  0  0  0  0  0  0  0  0  0  0  0  0  0  0  0
0  0  0  0  0  0  0  0  0  0  0  0  0  0  0  0  0  0  6  5  0  0  0  0  0  0  0  0  0  0  0  0  0  0  0  0
0  0  0  0  0  0  0  0  0  0  0  0  0  0  0  0  0  0  6  5  0  0  0  0  0  0  0  0  0  0  0  0  0  0  0  0
0  0  0  0  0  0  0  0  0  0  0  0  0  0  0  0  0  0  6  5  0  0  0  0  0  0  0  0  0  0  0  0  0  0  0  0
0  0  0  0  0  0  0  0  2  1  1  1  1  1  1  1  1  7  6  5  0  0  0  0  0  9  0  0  0  0  0  9  0  0  0  0
0  0  0  0  0  0  0  0  0  0  0 15 15  0 15 15  0  0 30 31  0  0  0  0  0  6  8  1  1  1  7  6  0  0  0  0
0  0  0  0  0  0  0  0  0  0  0 16 16  0 16 16  0  0 32 33  0  0  0  0  0  0  0  0  0  0  0  0  0  0  0  0
0  0  0  0  0  0  0  0  0  0  0 16 16  0 16 16  0  0 32 33  0  0  0  0  0  0  0  0  0  0  0  0  0  0  0  0
1  1  1  1  1  1  3  0  0  0  0 16 16  0 16 16  0  0 32 33  0  0  0  0  0  0  0  0  0  0  0  0  0  0  0  0
6  5  0  0 15 15 15  0  0  0  0 16 16  0 16 16  0  0 32 33  0  0  0  0  0  0  0  0  0  0  0  0  0  0  0  0
6  5 25 25 16 16 16  0  0  0  0 16 16  0 16 16  0  0 32 33  0  0  0  0  0  0  0  0  0  0  0  0  0  0  0  0
6  5 25 25 16 16 16  0  0  0  0 16 16  0 16 16  0  0 32 33  0  0  0  0  0  0  0  0  0  0  0  0  0  0  0  0
6  6  0  0 16 16 16  0  0  0  0 16 16  0 16 16  0  0 32 33  0  0  0  0  0  0  0  0  0  0  0  0  0  0  0  0
6  6  9  9  9  9  9  9  9  9  9  9  9  9  9  9  9  9  1  1  1  1  1  1  1  1  1  1  1  1  1  1  1  1  1  1
6  6  6  6  6  6  6  6  6  6  6  6  6  6  6  6  6  6  6  6  6  6  6  6  6  6  6  6  6  6  6  6  6  6  6  6
6  6  6  6  6  6  6  6  6  6  6  6  6  6  6  6  6  6  6  6  6  6  6  6  6  6  6  6  6  6  6  6  6  6  6  6
