0  0  0  0  0  0  0  0  0  0  0  0  0  0  0  0  0  0   0  0  0  0  0  0  0  0  0  0  0   0  0  0  0  0  0  0
0  0  0  0  0  0  0  0  0  0  0  0  0  0  0  0  0  0   0  0  0  0  0  0  0  0  0  0  0   0  0  0  0  0  0  0
0  0  0  0  0  0  0  0  0  0  0  0  0  0  0  0  0  0   0  0  0  0  0  0  0  0  0  0  0   0  0  0  0  0  0  0
0  0  0  0  0  0  0  0  0  0  0  0  0  0  0  0  0  0   0  0  0  0  0  0  0  0  0  0  0   0  0  0  0  0  0  0
0  0  0  0  0  0  0  0  0  0  0  0  0  0  0  0  0  0   0  0  0  0  0  0  0  0  0  0  0   0  0  0  0  0  0  0
0  0  0  0  0  0  0  0  0  0  0  0  0  0  0  0  0  0   0  0  0  0  0  0  0  0  0  0  0   0  0  0  0  0  0  0
0  0  21  0  0  0  0  0  59 59 59 59 59 59 59 59 59 59 59 59 59 59 59 59 59 59 59 59 59  59 59 59 59 59 59 59
0  0  0  0  0  0  0  0  62 62 62 62 62 62 62 62 62 62 62 62 62 62 62 62 62 62 62 62 62  62 62 62 62 62 62 62
0  0  0  0  0  0  0  0  0  0  0  15 15 15 15 15 15 15 15 15 15 15 15  0  0  0  0  0  0   0  0 62 62 62 62 62
0  0  0  0  0  0  0  0  0  0  0  16 16 16 16 16 16 16 16 16 16 16 16  0  0  0  0  0  0   0  0 62 62 62 62 62
0  0  0  0  0  0  0  0  0  0  0  16 16 16 16 16 16 16 16 16 16 16 16  0  0  0  0  0  0   0  0 62 62 62 62 62
0  0  0  0  0  0  0  0  0  0  0  16 16 16 16 16 16 16 16 16 16 16 16  0  0  0  0  0  0   0  0 62 62 62 62 62
63 64 64 64 64 64 64 64 64 64 64 64 64 64 64 64 64 64 64  64 64 64 64 65 0  0  0  20  0   0  0 62 62 62 62 62
0  0  0  0  0  0  0  0  0  0  0  0  0  0  0  0  0  0   0  0  0  0  0  0  0  0  0  0  0   0  0 62 62 62 62 62
0  0  0  0  0  0  0  0  0  0  0  0  0  0  0  0  0  0   0  0  0  0  0  0  0  0  0  0  0   0  0 62 62 62 62 62
0  0  0  0  0  0  0  0  0  0  0  0  0  0  0  0  0  0   0  0  0  0  0  0  0  0  0  0  0   0  0 62 62 62 62 62
59 59 59 59 59 59 59 59 59 59 59 59 59 59 59 59 59 59 59 59 59 59 59 59 59 59 59 59 59  59 60 62 62 62 62 62 
62 62 62 62 62 62 62 62 62 62 62 62 62 62 62 62 62 62 62 62 62 62 62 62 62 62 62 62 62  62 62 62 62 62 62 62
62 62 62 62 62 62 62 62 62 62 62 62 62 62 62 62 62 62 62 62 62 62 62 62 62 62 62 62 62  62 62 62 62 62 62 62
62 62 62 62 62 62 62 62 62 62 62 62 62 62 62 62 62 62 62 62 62 62 62 62 62 62 62 62 62  62 62 62 62 62 62 62
